1111111111
1200010001
1110101011
1100001111
1001000001
1011101101
1000001011
1010100011
1000001031
1111111111